　　　　　　　　　　　　　　　　　　　　　　　　　　　
　　　　　　　　　　　　　　　　　　　　　　　　　　　
　　　　　　　　　　　　　　　　　　　　　　　　　　　
　　　　■■■■■■■■■■■■■■■■■■■■■■■
　　　　■　　　　　　　　　　　　　　　　　　　　　■
　　　　■―――――――――――――――――――――■
　　　　■　　　　　　　　　　　　　　　　　　　　　■
　　　　■―――――――――――――――――――――■
　　　　■　　　　　　　　　　　　　　　　　　　　　■
　　　　■―――――――――――――――――――――■
　　　　■　　　　　　　　　　　　　　　　　　　　　■
　　　　■―――――――――――――――――――――■
　　　　■　　　　　　　　　　　　　　　　　　　　　■
　　　　■―――――――――――――――――――――■
　　　　■　　　　　　　　　　　　　　　　　　　　　■
　　　　■―――――――――――――――――――――■
　　　　■　　　　　　　　　　　　　　　　　　　　　■
　　　　■■■■■■■■■■■■■■■■■■■■■■■