　　　　　　　　　　　　　　　　　　　　　　　　　　　　　　　　　　　　　　　　
　　　　　　　　　　　　　　　　　　　　　　　　　　　　　　　　　　　　　　　　
　　　　　　　　　　　　　　　　　　　　　　　　　　　　　　　　　　　　　　　　
　　　　■■■■■■■■■■■■■■■■■■■■■■■■■■■■■■■■■■■■
　　　　■　　　　　　　　　　　▥　　　　　　　　　　　　　　　　　　　　　　■
　　　　■―――――――――――▥　　　　　　　　　　　　　　　　　　　　　　■
　　　　■　　　　　　　　　　　▥　　　　　　　　　　　　　　　　　　　　　　■
　　　　■―――――――――――▥　　　　　　　　　　　　　　　　　　　　　　■
　　　　■　　　　　　　　　　　▥　　　　　　　　　　　　　　　　　　　　　　■
　　　　■―――――――――――▥　　　　　　　　　　　　　　　　　　　　　　■
　　　　■　　　　　　　　　　　▥　　　　　　　　　　　　　　　　　　　　　　■
　　　　■―――――――――――▥　　　　　　　　　　　　　　　　　　　　　　■
　　　　■　　　　　　　　　　　▥　　　　　　　　　　　　　　　　　　　　　　■
　　　　■―――――――――――▥　　　　　　　　　　　　　　　　　　　　　　■
　　　　■　　　　　　　　　　　▥　　　　　　　　　　　　　　　　　　　　　　■
　　　　■　　　　　　　　　　　▥　　　　　　　　　　　　　　　　　　　　　　■
　　　　■　　　　　　　　　　　▥　　　　　　　　　　　　　　　　　　　　　　■
　　　　■　　　　　　　　　　　▥　　　　　　　　　　　　　　　　　　　　　　■
　　　　■　　　　　　　　　　　▥　　　　　　　　　　　　　　　　　　　　　　■
　　　　■　　　　　　　　　　　▥　　　　　　　　　　　　　　　　　　　　　　■
　　　　■　　　　　　　　　　　▥　　　　　　　　　　　　　　　　　　　　　　■
　　　　■　　　　　　　　　　　▥　　　　　　　　　　　　　　　　　　　　　　■
　　　　■　　　　　　　　　　　▥　　　　　　　　　　　　　　　　　　　　　　■
　　　　■■■■■■■■■■■■■■■■■■■■■■■■■■■■■■■■■■■■