　　　　　　　　　　　　　　　　　　　　　　　　　　　
　　　　　　　　　　　　　　　　　　　　　　　　　　　
　　　　　　　　　　　　　　　　　　　　　　　　　　　
　　　　■■■■■■■■■■■■■■■■■■■■■■■
　　　　■　　　　　　　　　　　　　　　　　　　　　■
　　　　■　　　　　　　　　　　　　　　　　　　　　■
　　　　■　　　　　　　　　　　　　　　　　　　　　■
　　　　■　　　　　　　　　　　　　　　　　　　　　■
　　　　■　　　　　　　　　　　　　　　　　　　　　■
　　　　■　　　　　　　　　　　　　　　　　　　　　■
　　　　■　　　　　　　　　　　　　　　　　　　　　■
　　　　■　　　　　　　　　　　　　　　　　　　　　■
　　　　■　　　　　　　　　　　　　　　　　　　　　■
　　　　■　　　　　　　　　　　　　　　　　　　　　■
　　　　■　　　　　　　　　　　　　　　　　　　　　■
　　　　■　　　　　　　　　　　　　　　　　　　　　■
　　　　■　　　　　　　　　　　　　　　　　　　　　■
　　　　■■■■■■■■■■■■■■■■■■■■■■■
　　　　□□□□□□□□□□□□□□　　　　　　　　　
　　　　□　　　　　　　　　　　　□　　　　　　　　　
　　　　□□□□□□□□□□□□□□　　　　　　　　　